@_#_____#
___#____#
_#______#
___##___#
_____#__#
_#_#__#_#
___#____#
__#__G__#
#########
