_#___@_____________#____#_###_#___________
_________#_#______#____#_#_____#____#__##_
__#_#____*_________#_###_#___#_###__##__#_
_###_________##*_______#___#__###____#__#_
###__#_#___#____________#_#____#_____##___
____________#___#___##______##_#_______##_
#_____#_##__#_______###__#_____________#_#
___##__#______#_#___##__##____#_##___##___
_____#__##_##_##_##__##__#________*_______
_____##_#___#_#______#_#_##________##_____
#___#____#___#__#__##___####_#_#_________G
