__@_##____######
_#_________#####
___#_________#_#
__#___________#G
__#########___##
_______________#
_##__________###
______#___######
___________#_###
###########__###
