__#_#_#___
_#_#_#_#___
__#@#_#_###
##_#_#_#_#
____#_#_#_
_##_##_##_
_#___#___#
_#___#___#
_##_##_##_
___#_#_G##
##########
