__@_##
_#__________##______#__#
___#____________#______#
##____##################
__#__##_____############
#__#__________##########
_____##_____G###########
__##____#____###########
########################
